1111111111111
1...1.......1
1.+.1.....+.1
1...........1
1...........1
111.........1
1.#.........1
1.#.......111
1.........111
1P........111
1111111111111
