111111111111111
1111111+1111111
1111111+1111111
111.........111
11..1.1.1.1..11
1..11.....11..1
1.11..1.1..11.1
1.....#P#.....1
1111..111..1111
111111111111111
