111111
1..+.1
1....1
1.#..1
1....1
1P...1
111111
