111111111111
1..1...11111
1..1......+1
1..........1
11111.111111
1...1....111
1...1....111
1.#.111..111
1........111
1P..1....111
111111111111
