1111111111111
111111...1111
111111...1111
111111...1111
1..1111#11111
1...........1
1.+11.1.11+.1
1...........1
11111#1111..1
1111...111111
1111.P.111111
1111...111111
1111111111111