1111111111111111111
1111111...1...1...1
1111111...#...#...1
1111111...1...1...1
11111111#1111111#11
1+++..1...1...1...1
1+++..#...#.P.1...1
1+++..1...1...1...1
1111111111111111#11
1111111...1...1...1
1111111...#...#...1
1111111...1...1...1
1111111111111111111
