111111111111111
111111...111111
11111....111111
11111....111111
111+1+1.11+...1
111.111..11...1
1...1..#..11.11
1.....#P#.....1
1...1.....1...1
111111111111111
